level 2
next_level assets/level_1.map
map
# # D # # -1
# G G G # -1
# G 0 G # -1
# 0 S 0 # -1
# # # # # -2